----------------------------------------------
   |     |     |                       |     |
-  -  -  -  -  -  -------------------  -  -  -
|     |     |     |        |           |  |  |
-------------  -  -  ----  -  ----------  -  -
|              |  |  |  |     |     |     |  |
-  -------  -------  -  -------  -  -  ----  -
|  |     |     |     |        |  |     |     |
-  -  -  -------  ----------  -  -------  ----
|  |  |           |           |  |     |     |
-  -  -------------  ----  ----  -  ----  -  -
|  |                 |     |     |        |  |
-  -------------------  ----  -------------  -
|  |              |  |        |        |  |  |
-  -  ----------  -  ----------  ----  -  -  -
|  |     |        |     |     |     |     |  |
-  ----  -  ----------  -  -  ----  ----  -  -
|        |           |  |  |        |  |  |  |
-------------------  -  -  ----  ----  -  -  -
|                 |     |     |  |     |  |  |
-  -------------  -------  ----  -  ----  -  -
|  |     |     |        |  |     |     |     |
-  -  -  -  -  -------  ----  -  ----  -------
|  |  |  |  |     |  |     |  |     |     |  |
-  -  -  -  ----  -  ----  -  ----  ----  -  -
|  |  |     |     |  |     |     |     |     |
-  -  -------  ----  -  -------  ----------  -
|     |  |     |     |           |        |  |
----  -  -  -  -  -------------  -  ----  -  -
|     |     |     |                 |         
----------------------------------------------